==================
=d   d   b dd   d=
=dC= d === dd  Cd=
=d = d = = dd = d=
=d = d = = dd = d=
=d = d = = dd = d=
=d = d =F= dd = d=
=d = d =d= dd = d=
=d = d =d=      d=
=d     #N=O=ddddd=
==================
