==================
=_____= =B=dddddd=
=_ddd_= =#=dddb  =
= dNd_=   =ddd dd=
= ____=   =_____d=
= =       == ===d=
= =C   C  == C   =
= ======_ _=     =
= ======___d     =
=      F  _   ==O=
==================